9.ox
.oo.......
.o........
.........o
.......o..
oo..o..o..
..oo......
....oo.o.o
..........
..........
