10.ox
oo.o...o.
oo...o..o
....ooo.o
.oo..oooo
o....oo..
.oo.oo.oo
...oo..o.
ooo.o....
..ooo..o.
.o...o..o
