9.ox
...o.....
......oo.
o...ooo.o
.o.....o.
....o..o.
...oo....
..o.o....
o.ooooo..
...o...o.
