9.ox
oo.oo..o..
o..ooooooo
..oo.o.ooo
oo.ooo....
o.o..o.o.o
o.ooo..ooo
.ooooooo.o
..oo.oo.oo
ooooo..oo.
